__#####_______________
###   ################
#!  ? T   T   T   TEW#
###   ################
__## ##_______________
__#   #_______________
__#   #_______________
__#   #_______________
__#####_______________