_############
##          #
#! E  E  E  #
##          #
_##########L#
_#        # #
_# W     ?# #
_#        # #
_#     ####L#
_#     T    #
_############