##################
#  W          W !#
#  ## #       #  #
#     # ##  # #  #
# #W        # #  #
# #   ####EE#   E#
# # T    #   EE###
#  E#            #
#      #  ######L#
#  ### #  #    # #
#  EEE #  # ?# #E#
#    T    #WE# #W#
#  E####  #### ###
#   EE           #
##################