__________########__________
__________#!     #__________
__________# T  T #__________
_____########  ########_____
_____#                #_____
_____#  #   ####   #  #_____
_____#                #_____
_____#  #   EE E   #  #_____
_____#                #_____
######  #    E E   #  ######
#   W#                #    #
# EE #  #   E EE   #  # E ?#
#    #                #    #
## ###       E        ### ##
#    #     WTWWTW          #
############################