________________####
#################  #
#!                ?#
########### #####  #
__#     #     #_####
__#  E        #_____
__#     #     #_____
__#############_____