_###########
##         #
#!    E    #
##        W#
_## T   T ##
__# #   # #_
__# T   T #_
__#W#   # #_
__# T   T #_
__# #   # #_
__# T   T #_
__#E#   #E#_
__#       #_
__###   ###_
____#   #___
__###   ###_
__#W      #_
__#   E  ?#_
__#       #_
__#########_