_###########____
## E#      #____
#!  # #E   #____
##  # #W   #____
_#    #    #____
######### ######
#     E   W#W  #
# ##########  ?#
#     E        #
################