#######____
#  !  #____
#     #____
#  E  #____
# ### #____
# WTW #____
# ### #____
#  E  #____
#     #####
# EEE #   #
# EEE   ? #
# EEE #   #
###########