__#####_______________
###   ################
#!  ?  T   T   T   TE#
###   ################
__## ##_______________
__#   #_______________
__#   #_______________
__#   #_______________
__#####_______________